_***********************************************************************************************************************************************************************************************************************************************************************************************************************************************************************_
_***********************************************************************************************************************************************************************************************************************************************************************************************************************************************************************_
_***********************************************************************************************************************************************************************************************************************************************************************************************************************************************************************_
_***********************************************************************************************************************************************************************************************************************************************************************************************************************************************************************_
_***********************************************************************************************************************************************************************************************************************************************************************************************************************************************************************_
_***********************************************************************************************************************************************************************************************************************************************************************************************************************************************************************_
_***********************************************************************************************************************************************************************************************************************************************************************************************************************************************************************_
_***********************************************************************************************************************************************************************************************************************************************************************************************************************************************************************_
_***********************************************************************************************************************************************************************************************************************************************************************************************************************************************************************_
_***********************************************************************************************************************************************************************************************************************************************************************************************************************************************************************_
_***********************************************************************************************************************************************************************************************************************************************************************************************************************************************************************_
_***********************************************************************************************************************************************************************************************************************************************************************************************************************************************************************_
_***********************************************************************************************************************************************************************************************************************************************************************************************************************************************************************_
_***********************************************************************************************************************************************************************************************************************************************************************************************************************************************************************_
_***********************************************************************************************************************************************************************************************************************************************************************************************************************************************************************_
_***********************************************************************************************************************************************************************************************************************************************************************************************************************************************************************_
_***********************************************************************************************************************************************************************************************************************************************************************************************************************************************************************_
_***********************************************************************************************************************************************************************************************************************************************************************************************************************************************************************_
_***********************************************************************************************************************************************************************************************************************************************************************************************************************************************************************_
_***********************************************************************************************************************************************************************************************************************************************************************************************************************************************************************_
_***********************************************************************************************************************************************************************************************************************************************************************************************************************************************************************_
_:::::::::::::::::::::::::::::::::::::::::::::::::::::::::::::::::::::::::::::::::::::::::::::::::::::::::::::::::::::::::::::::::::::::::::::::::::::::::::::::::::::::::::::::::::::::::::::::::::::::::::::::::::::::::::::::::::::::::::::::::::::::::::::::::::::::::::::::::::::::::::::::::::::::::::::::::::::::::::::::::::::::::::::::::::::::::::::::::::::::_
_8$888888$88888$8$888$8888$8888888$888888$888888$888888$888888$888888$888888$888888$888888$888888$888888$8$88$888888$888888$888888$888888$888888$888888$888888$888888$888888$888888$888888$8888888$$8888$888888$88888888$888888$88888888$888888$88888888$888888$8888$88888888$888888$8888$88888888$888888$8888$88888888$888888$8888888$888888$8888888888$888888$88888888_
_8$888888$88888$8$888$8888$8888888$888888$888888$888888$888888$888888$888888$888888$888888$888888$888888$8$88$888888$888888$888888$888888$888888$888888$888888$888888$888888$888888$888888$8888888$$8888$888888$88888888$888888$88888888$888888$88888888$888888$8888$88888888$888888$8888$88888888$888888$8888$88888888$888888$8888888$888888$8888888888$888888$88888888_